Text	Author	Source
Everything flows and nothing abides. Everything gives way and nothing stays fixed.	Heraclitus	
To do the useful thing, to say the courageous thing, to contemplate the beautiful thing: that is enough for one man’s life	TS Elliot	The Use of Poetry and the Use of Criticism
Bite off more than you can chew and then chew like crazy.	Crocodile Dundee	
Most people are other people. Their thoughts are someone else's opinions, their lives a mimicry, their passions a quotation.	Oscar Wilde	
Only those who risk going too far can possibly find out how far they can go.	TS Elliot	
Mediocrity knows nothing higher than itself. Talent instantly recognises genius.	Sir Arthur Conan Doyle 	
Snowmen fall to Earth unassembled	Raymond Aaron	
When we're away from home, we're all inclined to think we left a paradise behind	Johann von Goethe	Faust
All who joy would win must share it. Happiness was born a twin	Byron	
You cannot truly listen to anyone and do anything else at the same time.	M. Scott Peck	
Do your work; not just your work and no more. But a little more for the lavishing's sake. That little which is worth all the rest.  And if you suffer, as you must, and if you doubt, as you must, do your work. Put your heart into it, and the sky will clear. Then out of your doubt and suffering will be born the supreme joy of life.	Dean Briggs	
Everything we hear is an opinion, not a fact. Everything we see is a perspective, not the truth.	Marcus Aurelius	
There are two ways to be fooled. One is to believe what isn't true; the other is to refuse to believe what is true.	Soren Kierkegaard	
My grief lies onward, my joy behind.	William Shakespeare	Sonnets
Savor the fruit of life, my young friends. It has a sweet taste when it is fresh from the vine. But don't live too long. The taste turns bitter... after a time.	Kor	StarTrek:Deep Space Nine
Most people overestimate what they can do in a day, and underestimate what they can do in a month. We overestimate what we can do in a year, and underestimate what we can accomplish in a decade	Matthew Kelly	The Long View
I was obliged to be industrious. Whoever is equally industrious will succeed equally well.	JS Bach	
We learn from history that we learn nothing from history.	Georg Wilhelm Friedrich Hegel	
Care about what other people think and you will always be their prisoner.	Lao Tzu	
Success breed complacency. Complacency breeds failure. Only the paranoid survives.	Andy Gorves	
What we need, we, is fixedness intense, Unequalled effort, strive that shall not cease, Is night, the bitter night of labour, whence Arises, sun-like, slow, the Master-piece.	Paul Verlaine	
Throughout the whole of life one must continue to learn to live. And what will amaze you even more, throughout life one must learn to die.	Seneca	
If you're not part of the solution, you're part of the problem.	Eldridge Cleaver	
Those things that hurt instruct.	Benjamin Franklin	
But what matters an eternity of damnation to one who has found in a second an infinite joy.	Charles Baudelaire	
To do the useful thing, to say the courageous thing, to contemplate the beautiful: that is enough for one man's life.	T.S. Eliot	The Use of Poetry and Use of Criticism
And I’m her arms and in her heaving breasts, She calls men’s eyes to be her servile guests	Charles Baudelaire	Flowers of Evil
She calls men’s eyes to be her servile guests	Viktor Frankl	Man's search for meaning
Control thy passions lest they take vengeance on thee.	Epictetus	
I am an enigma to myself.	Augustine	
Wie viel ist aufzuleiden!	Rilke	
It doesn't really matter we expect from life, but rather what life expects of us.	Viktor Frankl	Man's Search For Meaning
Suffering ceases to be suffering the moment it has a meaning.	Viktor Frankl	Man's Search For Meaning
I care not so much what I am to others as what I am to myself.	Michel de Montaigne	
May my soul bloom in love for all existence.	Rudolf Steiner	
The descent to Hades is the same from every place.	Axanagoras	
A ceremony in which rings are put on the finger of the lady and through the nose of the gentleman.	Herbert Spencer	
There are things which must cause you to lose your reason or you have none to lose.	Lessing	
Tyranny is always better organised than freedom.	Charles Peguy	
Gambling is the child of avarice, the brother of iniquity and the father of mischief.	George Washington	
Accept what is, let go of what was, have faith in what will be.	Pammy Johal	
Performance drives success. But when performance can't be measured, networks drive success.	Albert-Laszlo Barabasi	
He who listens well notes well what he hears.	Dante	Canto XV, The Divine Comedy: Inferno
Wrong it is for a man to have again what he once cast off.	Dante	Canto XIII, The Divine Comedy: Inferno
Wealth cannot be what we want, for it serves only as a means of getting something else.	Aristotle	
It is the mark of an educated mind to be able to entertain a thought without accepting it.	Aristotle	
The ultimate effect of shielding men from the effects of folly is to fill the world with fools.	Herbert Spencer	
The aim of education is not knowledge but action.	Herbert Spencer	
What is the joy of a life without sadness?	Unknown	
You may delay but time will not. And lost time is never found again.	Benjamin Franklin	
Conquer yourself rather than the world.	Réné Descartes	
Neglect is the coldest of winter winds.	Thomas Hardy	Desperate Remedies
Too many have dispensed with generosity in order to practice charity.	Albert Camus	
How true it is that proffered service stinks.	Geoffrey Chaucer	The Cantebury Tales
Manifest plainness; Embrace simplicity, reduce selfishness, have few desires.	Lao Tzu	
Progress is impossible without change, and those who cannot change their minds cannot change anything.	George Bernard Shaw	
The life of man, solitary, poor, nasty, brutish and short.	Thomas Hobbes	
We must as second best accept the least of the evils.	Aristotle	
Be moderate in order to taste the joys of life in abundance.	Epicurus	
In the depth of winter, I learned that within me lay an invincible summer.	Albert Camus	
Discretion in speech is more than eloquence.	Sir Francis Bacon	
Be ready to pay the price of your dreams. Free cheese can only be found in a mousetrap.	Paulo Coelho	
Night does not cover our troubles, it brings them to the mind.	Seneca	
Every battle is won before it is begun.	Sun-Tzu	
Character, like a photograph, develops in darkness.	Yousuf Karsh	
Happiness is a state of activity.	Aristotle	
So very difficult a matter is it to trace and find out the truth of anything by history.	Plutarch	
The wicked act begets more after it.	Aeschylus	
If only the fool would persist in his folly, he would become wise.	William Blake	
Those who would give up essential liberty to purchase a little temporary safety deserve neither liberty nor safety.	Benjamin Franklin	
We can solve any problem by introducing an extra level of indirection.	David Wheeler	
Of all the sexual aberrations, chastity is the strangest.	Anatole France	
Pity runs swiftly in a noble heart.	Geoffrey Chaucer	The Knight's Tale, The Cantebury Tales
Hope is not a strategy. Luck is not a factor. Fear is not an option.	James Cameron	
Do not spoil what you have by desiring what you have not; remember that what you now have was once among the things you only hoped for.	Epicurus	
Burn old dogs. Drink old wine. Read old books. Keep old friends.	Alfonso X (King of Spain)	
Quis custodiet ipsos custodes?	Latin phrase	
Use laws that are old but food that is fresh.	Periander of Corinth	
There's nothing remarkable about it. All one has to do is hit the right keys at the right time and the instrument plays itself.	Johan Sebastian Bach	
Not my circus. Not my monkeys.	Polish Proverb	
Praxis tendatum docebit - Practice will teach those who try.	Carl Friedrich Gauß	
We made the wrong mistake.	Yogi Berra	
To laugh often and much; to win the respect of the intelligent people and the affection of children; to earn the appreciation of honest critics and endure the betrayal of false friends; to appreciate beauty; to find the beauty in others; to leave the world a bit better whether by a healthy child, a garden patch, or a redeemed social condition; to know that one life has breathed easier because you lived here. This is to have succeeded.	Ralph Waldo Emerson	
The firmest faith is in the fewest words.	Dyer	
Content makes poor men rich; discontent makes rich men poor.	Benjamin Franklin	
What has been will be again, what has been done will be done again, there is nothing new under the sun.	Ecclesiastes 1:9	
Contentment is a rare bird, but it sings sweetly in the breast.	Martin Luther	
Between two evils, I generally like to pick the one I haven't tried before.	Mae West	
Nothing tastes as good as skinny feels.	Kate Moss	
A man is rich in proportion to the things he is willing to let alone.	Henry David Thoreau	
Money is coined liberty	Fyodor Dostoesvsky	
Be a philosopher, but, admidst all your philosophy, be still a man.	David Hume	
Reason is, and ought only to be, the slave of the passions.	David Hume	
It is difficult to free fools from the chains they revere.	Voltaire	
A classic is something everybody wants to have read, but no one wants to read.	Mark Twain	
You don't know anything until you have practiced.	Richard Feynman	
A politician who lives by cleaniness dies by dirt	Theodore Dalrymple	
Everything should be made as simple as possible, but not simpler.	Albert Einstein	
Life shrinks or expands in proportion to one’s courage	Anaïs Nin	
For every complicated problem there is a solution that is simple, direct, understandable and wrong	H. I. Menchen	
Everything has been said before, but since no one listens, we must start again.	André Gide	
Toutes choses sont dites déja; mais comment personne n'écoute, if faut toujours recommencer	André Gide	
Trust none of what you hear, some of what you read, half of what you see.	Old trader adage	
All movements go too far.	Bertrand Russell	
How much there is in the world I do not want.	Socrates	
It's not supposed to be easy. Anybody who finds it easy is stupid.	Charlie Munger	
It is a sad thing when men have neither the wit to speak well nor the judgement to hold their tongues.	Jean de la Bruyere	
I mistrust all systemizers and avoid them. The will to a system is a lack of integrity.	Friedrich Nietzsche	
Never mistake activity for achievement	John Wooden	
Know thy self, know thy enemy. A thousand battles, a thousand victories.	Sun-Tzu	
Choose the life that is most useful, and habit will make it the most agreeable.	Sir Francis Bacon	
The fool generalizes the particular; the nerd particularizes the general; some do both; and the wise does does neither	Nassim Nicholas Taleb	
He who despairs over an event is a coward, but he who holds hope for the human condition is a fool.	Albert Camus	
The greatest challenge to any thinker is stating the problem in a way that will allow a solution.	Bertrand Russell	
A likely impossibility is always preferable to an unconvincing possibility.	Aristotle	
Over one's mind and over one's body the individual is sovereign.	John Stuart Mill	
No price is too high to pay for the privilege of owning yourself.	Friedrich Nietzsche	
Our greatest fear should not be of failure, but of succeeding at something that doesn't really matter.	D.L. Moody	
The greater danger for most of us lies not in setting our aim too high and falling short; but in setting our aim too low, and achieving our mark.	Michaelangelo	
Play always as if in the presence of a master.	Robert Schumann	
Nothing is so firmly believed as that which we least know.	Michel de Montaigne	
Life has its own hidden forces that can only be discovered by living.	Soren Kierkegaard	
It’s not how well you play the game, it’s deciding what game you want to play.	Kwame Appiah	
If you would only recognize that life is hard, things would be so much easier for you.	Justice Louis Brandeis	
Until you make the unconscious conscious, it will direct your life and you will call it fate.	Carl Jung	
Time is the most valuable thing a man can spend.	Theophrastus	
I count him braver who overcomes his desires than him who overcomes his enemies.	Aristotle	
The limits of my language mean the limits of my world.	Ludwig Wittgenstein	
Commitment is doing the thing you said you were going to do long after the mood you said it in has left you.		
In his errors a man is true to type. Observe the errors and you will know the man.	Confucius	
We must accept finite disappointment. But never lose infinite hope.	Dr Martin Luther King Jr.	
Injustice anywhere is a threat to justice everywhere.	Dr. Martin Luther King Jr.	
The man of petty ambition if invited to a dinner would be eager to be set next to his host.	Theophrastus	
Do not impose on others what you yourself do not desire.	Confucius	
It is nobler to declare oneself wrong than to insist on being right - especially when one is right.	Friedrich Nietzsche	
Don't find fault, find a remedy; anybody can complain.	Henry Ford	
Nothing is more certain than the defeat of a man who gives up.	George Sheenan	
Criticism is something we can avoid easily by saying nothing, doing nothing and being nothing.	Aristotle	
Choose a life that is most useful, and habit will make it the most agreeable.	Sir Francis Bacon	
There is but one cause of human failure. And that is man's lack of faith in his true self.	William James	
He that will not apply new remedies must expect new evils; for time is the greatest innovator.	Sir Francis Bacon	
Thinking is the hardest work there is, which is probably why so few people engage in it.	Henry Ford	
Thinking is easy. Acting is hard. But acting in accordance with your thinking is the hardest thing in the world.	Johann von Goethe	
I care not so much what I am to others as what I am to myself.	Michel de Montaigne	
When brothers agree, no fortress is so strong as their common life.	Antisthenes	
The most savage controversies are those about matters as to which there is no good evidence either way.	Bertrand Russell	
First do it, then do it right, then do it better.	Addy Osmani	
The best laid plans of mice and men often go astray.	Robert Burns	
Time has sharp teeth that destroy everything.	Simonides of Ceos	
In the confusion of all ranks, everyone appears to be what he is not.	Alexis de Tocqueville	
He who hesitates is lost.	Cato	
On n'est jamais heureux que dans le bonheur qu'on donne. Donner, c'est recevoir	Abbé Pierre	
The preservation of liberty is more about the way we hold our beliefs than the beliefs that we hold.	Robin Koerner	
In theory, there is no difference between theory and practice. But in practice, there is.	Yogi Berra, Al North	
Don't limit yourself to someone's opinion of your capabilities. Be you. Dream, plan, execute!	Steve Maraboli	
This too shall pass	Persian adage	
Nature is wont to hide herself.	Heraclitus of Ephesus	
Tolerance is the virtue of the man without convictions.	G.K. Chesterton	
A wise man sees as much as he ought, not as much as he can.	Michel de Montaigne	
Failure is when you talk yourself out of becoming something amazing.	Manisha Agarwal	
One should never know too precisely whom one has married.	Friedrich Nietzsche	
Men feel the good less intensely than the bad.	Livy	Livy's Annals
Madness is rare in individuals, but in groups, parties, nations, it is the rule.	Friedrich Nietzsche	
You can't build a reputation based on what you are going to do.	Henry Ford	
The trick is to fix the problem you have rather than the problem you want.	Bram Cohen	
There are some defeats more triumphant than victories.	Michel de Montaigne	
Liquidity is a coward. It's never there when you need it.	Unknown	
A man content to go to heaven alone will never go to heaven.	Boethius	
I'm altering the deal. Pray I don't alter it any further.	Darth Vader	
A man is not old until regrets take the place of his dreams.	Yiddish Proverb	
I believe your conjecture is slightly orthogonal to reality.	Charles Hoskinson	
Habit, if uncontrolled, becomes necessity.	St Augustine	
We know truth; not only by reason, but also by the heart.	Blaise Pascal	
Mudam-se os tempos, mudam-se os valores.	Luis de Camoes	
O ódio é como veneno; só funciona se voce beber.	Leandro Karnal	
Nao bate tambor para maluco dancar.	Leandro Karnal	
How can you think yourself a great man, when the first accident that comes along can wipe you out completely?	Euripides	
Criticising is easy. Creating something worth criticising is the hard part.	Kelsey Hightower	
What do we live for, if not to make life less difficult for each other?	George Elliot	
What the superior man seeks is in himself. What the mean man seeks is in others.	Confucius	
Do not weep. Do not wax indignant. Understand.	Baruch Spinoza	
Man needs difficulties; they are necessary for health.	Carl Jung	
When the debate is over, slander becomes the tool of the loser.	Socrates	
One should die proudly when it is no longer possible to live proudly.	Friedrich Nietzsche	
Seek not good from without: seek it from within yourselves, or you will never find it.	Epictetus	
It is a kind of spiritual snobbery that makes people think they can be happy without money.	Albert Camus	
The world is the will to power and nothing besides.	Friedrich Nietzsche	
Sympathy for all would be tiranny for thee, my good neighbour.	Eleanor Ostrom	
If you think you're enlightened, try spending a week with your family.	Ram Daas	
This world of ours appears to be separated by a slight and precarious margin of safety from a most singular and unexpected danger.	Arthur Conan Doyle	
Good fences make good neighbors.	Robert Frost	Mending Wall
What matters isn’t what a person has or doesn’t have; it is what he or she are afraid of losing.	Nassim Taleb	
We are generally the better persuaded by the reasons we discover ourselves than by those given to us by others.	Blaise Pascal	
Be sure to know the condition of your flocks, give careful attention to your herds; for riches do not endure forever, and a crown is not secure for all generations.	Proverbs 27:23-24	
A friend is a second self.	Aristotle	
Poverty has its freedoms; opulence has its obstacles.	Denis Diderot	
How many things by season season'd are...	William Shakespeare	The Merchant of Venice
Every society honours its live conformists and its dead troublemakers.	Mignon McLaughlin	
They may forget what you said but they will not forget how you made them feel.	Carl W Buechner	
Honour all men. Love the brotherhood. Fear God. Honour the king.	1 Peter 2:17	
The time is always right to do what is right.	Martin Luther King Jr.	
The souls of animals infuse themselves into the trunks of men.	Pythagoras	
I am always doing that which I can not do, in order that I may learn how to do it.	Pablo Picasso	
Work hard in silence. Let your success be your noise.	Frank Ocean	
But in the end one needs more courage to live than to kill himself.	Albert Camus	
Until the lions have their own historians, the history of the hunt will always glorify the hunters.	Chinua Achebe	
Laws come and go; the ethics stay.	Nassim Taleb	Why each one should eat his own turtles
There's no easier way to cure foolishness than leave a man to be foolish.	John Graham	Letters from a self-made merchant
Open rebuke is better than secret love.	Proverbs 27:5	
Every man prefers belief to the exercise of judgement.	Seneca	
All beginnings are delightful; the threshold is the place to pause.	Johann Wolfgang von Goethe	
A gem cannot be polished without friction, nor a man perfected without trials.	Seneca	
We are more frightened than hurt; and we suffer more from imagination than from reality.	Seneca	
I have often thought upon death, and I find it the least of all evils.	Francis Bacon	
All cruelty springs from weakness.	Seneca	
Those who make no mistakes are making the biggest mistake of all - they are attempting nothing new.	Anthony de Mello	
He suffers more than necessary, who suffers before it is necessary.	Seneca	
The whole future lies in uncertainty: live immediately.	Seneca	
Timendi causa est nescire - Ignorance is the cause of fear.	Seneca	
As is a tale, so is life: not how long it is, but how good it is, is what matters.	Seneca	
The man who has anticipated the coming of troubles takes away their power when they arrive.	Seneca	
Wherever there is a human being, there is an opportunity for a kindness.	Seneca	
All things that are, are with more spirit chased than enjoyed.	Shakespeare	The Merchant of Venice
Venenum in auro bibitur - Poison is drunk from a gold cup.	Seneca	
The brave may not live forever, but the cautious don't live at all.	Ashley L	
Hope in reality is the worst of all evils because it prolongs the torment of man.	Friedrich Nietzsche	
Never doubt that a small group of thoughtful citizens can change the world. Indeed, it is the only thing that ever has.	Margaret Mead	
The facts are true. The news is fake.	Donald Trump	
It is not wisdom but authority which makes the law.	Thomas Hobbes	
When you're forced to be simple, you're forced to face the real problem. When you can't deliver ornament, you have to deliver substance.	Paul Graham	
Education, therefore, is a process of living and not a preparation for future living.	John Dewey	
To dare is to lose one's footing momentarily. Not to dare is to lose oneself.	Soren Kierkegaard	
Science does not know its gratitude to imagination.	Ralph Waldo Emerson	
Even on the most exalted throne in the world we are still sitting on our own bottom.	Michel de Montaigne	
Patience is bitter but its fruit is sweet.	Aristotle	
Neither a lofty degree of intelligence nor imagination nor both go to the making of genius. Love, love, love is the soul of genius.	Wolfgang Amadeus Mozart	
Control thy passions, lest they take vengeance on thee.	Epictetus	
In order to understand the world, one has to turn away from it on occasion.	Albert Camus	
The greatest prison of all is the one our ego puts us in.	Shane Parrish	
Made weak by time and fate, but strong in will to strive, to seek, to find, and  not to yield.	Tennyson	
With the exercise of self-trust new powers shall appear.	Ralph Waldo Emerson	
Keep buggering on.	Sir Winston Churchill	
Behind mountains are more mountains.	Haitian Proverb	
Solvitur ambulando (It is solved by walking).	Latin Phrase	
You can't run your life from your inbox.	Arianna Huffington	
Nobody realizes that some people expend tremendous energy merely to be normal.	Albert Camus	
On te demandera de faire le mal oú que tu ailles. C'est le fondement de la vie: avoir a violer sa propre identite	Philip K. Dick	
The discomfort of being uncertain is preferable to the certainty of being wrong.	Shane Parrish	The Value of Grey Thinking - Farnam Street
The best political community is formed by citizens of the  middle class.	Aristotle	
Man is by nature a political animal.	Aristotle	
Objective judgement, now at this very moment. Unselfish action,now at this very moment. Willing acceptance - now at this very moment - of all external events. That is all you need.	Marcus Aurelius	
Nothing is more despicable than respect based on fear.	Albert Camus	
It is necessary to be a fox to discover the snares and a lion to terrify the wolves.	Niccolo Machiavelli	
Opinions are like belly buttons. Everybody's got one.	Unknown	
If everyone is thinking alike, then somebody isn't thinking.	George S. Patton	
It is not the oath that makes us believe a man, but the man the oath.	Aeschylus	
Life is short...Get what you can from the present - thoughtfully, justly. Unrestrained moderation.	Marcus Aurelius	
When you have to deal with someone, as yourself: What does he mean by good and bad? If he thinks x or y about pleasure and pain (and what produces them), about fame and disgrace, about death and life, then it shouldn't shock or surprise you when he does x or you. In fact, I'll remind myself that he has no real choice.	Marcus Aurelius	
Live by faith or die by fear.	Pastor Wes Richards	
...the present is all we have to live in. Or to lose.	Marcus Aurelius	
Give yourself a gift - the present moment.	Marcus Aurelius	
Self-control in the man who does not act wisely is by itself, the weakest of all things.	Aeschylus	
The man who moves a mountain begins by carrying away a small stone.	Confucius	
It is silly to try to escape other people's faults. They are inescapable. Just try to escape your own.	Marcus Aurelius	
But true good fortune is what you make for yourself.	Marcus Aurelius	
All men by nature desire knowledge.	Aristotle	
Learn to ask of all actions, 'Why are they doing that?'. Starting with your own.	Marcus Aurelius	
Our envy always lasts longer than the happiness of those we envy.	Heraclitus of Ephesus	
If you don't have a consistent goal in life, you can't live it in a consistent way.	Marcus Aurelius	
Everything is transitory - the knower and the known.	Marcus Aurelius	
The value of attentiveness varies in proportion to its object. You're better off not giving the small things more attention than they deserve.	Marcus Aurelius	
If you seek tranquility do less.	Marcus Aurelius	
Observe your enemies, for they first find your faults.	Antisthenes	
Try being informed, instead of just opinionated.	Unknown	
Epithets for yourself: Upright. Modest. Straightforward. Sane. Cooperative. Disinterested.	Marcus Aurelius	
You have to assemble your life yourself - action by action. And be satisfied if each one achieves its goal, as far as it can. No one can keep that from happening.	Marcus Aurelius	
Dig deep; the water is down there. And as long as you keep digging, it will keep bubbling up.	Marcus Aurelius	
Think of yourself as dead. You have lived your life. Now take what's left and live it properly.	Marcus Aurelius	
Blame no one. Set people straight, if you can. If not, just repair the damage.	Marcus Aurelius	
Pride is the burden of a foolish person.	Unknown	
The price of inaction is far greater than the cost of making a mistake.	Meister Eckhart	
Ego is the anaesthesia that deadens the pain of stupidity.	Unknown	
By definition government has no conscience. Sometimes it has a policy, but nothing more.	Albert Camus	
Practise even what seems impossible.	Marcus Aurelius	
It is essential to practice reading as an art.	Friedrich Nietzsche	
To fear love is to fear life; and those who fear life are already three parts dead.	Bertrand Russell	
Long I've held silence a remedy for harm.	Aeschylus	
Two things are infinite: the universe and human stupidity; and I'm not sure about the universe.	Albert Einstein	
Human are driven by a perpetual and restless desire for power.	Thomas Hobbes	
People who cannot handle critique usually have a deeper problem than the one you are trying to point out.	Philosophy Muse	
No man was ever wise by chance.	Seneca	
There is nothing permanent except change.	Heraclitus of Ephesus	
Everything that one thinks about a lot becomes problematic.	Friedrich Nietzsche	
Be yourself; everyone else is already taken.	Oscar Wilde	
What is a rebel? A man who says no.	Albert Camus	
Don't explain your philosophy. Embody it.	Epictetus	
The mind is that which is roused and directed by itself. It makes of itself what it chooses. It makes what it chooses of its own experience	Marcus Aurelius	
The only true wisdom is knowing that you know nothing.	Socrates	
Pride is a master of deception: when you think you're occupied in the weightiest business, that's when he has you in his spell.	Marcus Aurelius	
Change and flux constantly remake the world, just as the incessant progression of time remakes eternity.	Marcus Aurelius	
Old sins cast long shadows.	Joan Gidding	
What injures the hive injures the bee.	Marcus Aurelius	
Cheating is often more efficient.	Seven of Nine	Startrek: Voyager
The world of reality has its limits; the world of imagination is boundless.	Jean Jacques Rousseau	
The best investment you will ever make is in yourself	Habit Nest	
The only Zen you find on tops of mountains is the Zen you bring there.	Robert M. Pirsig	
Autumn is a second spring when every leaf is a flower.	Albert Camus	
Humankind differs from the animals only by a little, and most people throw that away.	Confucius	
Life is really simple, but we insist on making it complicated.	Confucius	
In this world there are only two tragedies. One is getting what one wants and the other is not getting it.	Oscar Wilde	
The real voyage of discovery consists not in seeking new lands but seeing with new eyes.	Marcel Proust	
Let us be grateful to people who make us happy; they are the charming gardeners who make our souls blossom.	Marcel Proust	
Happiness is beneficial for the body, but it is grief that develops the powers of the mind.	Marcel Proust	
We don't receive wisdom; we must discover it for ourselves after a journey that no one can take for us or spare us.	Marcel Proust	
If a little dreaming is dangerous, the cure for it is not to dream less but to dream more, to dream all the time.	Marcel Proust	
Rather fail with honour than to succeed by fraud.	Sophocles	
Love is space and time measured by the heart.	Marcel Proust	
Man is born free, but everywhere he is in chains.	Jean Jacques Rousseau	
Let us leave the beautiful women to men with no imagination.	Marcel Proust	
Illness is the doctor to whom we pay most heed; to kindness, to knowledge, we make promise only; pain we obey.	Marcel Proust	
We are healed from suffering only by experiencing it to the full.	Marcel Proust	
Like many intellectuals, he was incapable of saying a simple thing in a simple way.	Marcel Proust	
Remembrance of things past is not necessarily the rememberance of things as they were.	Marcel Proust	
It is our imagination that is responsible for love, not the other person.	Marcel Proust	
I'm monogamous in all my relationships	Esther Perel	
Even when laws have been written down, they ought not always to remain unaltered.	Aristotle	
He who will not economise will have to agonise.	Confucius	
I would rather have questions that can't be answered than answers which can't be questioned.	Richard Feynman	
Everything in the world is about sex except sex. Sex is about power.	Oscar Wilde	
It is possible to fail in many ways...while to succeed is possible only in one way.	Aristotle	
You are never more likely to make a grammatical error than when correcting someone else's grammar.	The iron law of nitpicking	
If you write anything criticizing editing or proofreading, there will be a fault of some kind in what you have written.	Muphry's Law	
Moderation is the secret of survival.	Manly Hall	
The world is nothing but change. Our life is only perception.	Marcus Aurelius	
Getting over yourself offers exceptional returns.	Shane Parrish	
The envious person grows lean with the fatness of their neighbour.	Socrates	
To begin, begin.	William Wordsworth	
Growth begins when we begin to accept our own weakness.	Jean Vanier	
Be not ashamed of mistakes and thus make them crimes.	Confucius	
It is greed to do all the talking but not to want to listen at all.	Democritus	
If you do not create your destiny, you will have your fate inflicted upon you.	William Irwin Thompson	
There was never a genius without a tincture of madness.	Aristotle	
There are no secrets except those that keep themselves.	George Bernard Shaw	
The energy of the mind is the essence of life.	Aristotle	
A market is never saturated with a good product, but it is very quickly saturated with a bad one.	Henry Ford	
We are never definitely right, we can only be sure we are wrong.	Richard Feynman	
At first, people refuse to believe that a strange new thing can be done, then they begin to hope it can be done, then they see it can be done - then it is done, and all the world wonders why it was not done centuries ago.	Frances Hodgson Burnett	
I am long on ideas, but short on time. I expect to live only about a hundred years.	Thomas Edison	
There is no dependence that can be sure but a dependence on one's self.	John Gray	
People would do better, if they knew better.	Jim Rohn	
Our plans miscarry because they have no aim. When a man does not know what harbor he is making for, no wind is the right wind.	Seneca	
Time discovers truth.	Seneca	
An unexamined life is not worth living.	Socrates	
None of us is forbidden to pursue our own good.	Marcus Aurelius	
Responsibility is the price for greatness.	Winston Churchill	
Always pitty the thinkers, for they are always cursed with their imaginations.	Atticus	
If you don't find a way to make money while you sleep you will work till you die.	Warren Buffett	
Life is too short and we all die alone.	Unknown	
How much more damage anger and grief do than the things that cause them.	Marcus Aurelius	
Hope is a poor hedge	Unknown	
He who dares not offend cannot be honest.	Thomas Paine	
Maturity consists in having rediscovered the seriousness one had as a child at play.	Friedrich Nietzsche	
The young are permantely in a state resembling intoxication.	Aristotle	
If death was the end of all, the wicked would have a good bargain in dying.	Socrates	
The world is changed by your example, not by your opinion.	Paulo Coelho	
Nihil nisi bonum- of the dead speak no evil	Latin phrase	
Primum non nocere- first do no harm	Latin Phrase	
He who establishes his argument by noise and command, shows that his reason is weak.	Michel de Montaigne	
Memory is the treasury and guardian of all things.	Cicero	
On matters of style swim with the current, but on matters of principle, stand like a rock.	Thomas Jefferson	
Great grief does not of itself put an end to itself.	Seneca	
Then imitate the action of a tiger. Stiffen the sinews, summon up the blood.	Shakespeare	
Advice is what we ask for when we already know the answer but wish we didn't.	Jong	
In all things of nature there is something of the marvellous.	Aristotle	
All religions must be tolerated, for every man must get to heaven in his own way.	Epictetus	
The art of dining well is no slight art, the pleasure not a slight pleasure.	Michel de Montaigne	
I measure the strength of a spirit by how much truth it can take.	Friedrich Nietzsche	
A child of five could understand this. Send someone to fetch a child of five.	Groucho Marx	
f you think of the world as a place intended simply for your happiness, you find it quite intolerable.	C.S. Lewis	
I never admire another's fortune so much that I became dissatisfied with my own.	Cicero	
Liberty demands responsibility. That is why most men dread it.	George Bernard Shaw	
If you must play, decide on three things at the start: the rules of the game, the stakes, and the quitting game.	Chinese proverb	
The average man is a conformist, accepting miseries and disasters with the stoicism of a cow standing in the rain.	Colin Wilson	
To be engrossed by something outside ourselves is a powerful antidote for the rational mind, the mind that so frequently has its head up its own ass.	Anne Lamott	
Morality is simply the attitude we adopt toward people we personally dislike.	Oscar Wilde	
There is not enough time to do all the nothing we want to do.	Bill Watterson	
He who is not very strong in memory should not meddle with lying	Michel de Montaigne	
Bear in mind that you should conduct yourself in life as at a feast	Epictetus	
 It is the sign of a great mind to prefer things in measure to things in excess.	Seneca	
Genius is only a superior power of seeing.	John Ruskin	
I not only use all the brains that I have, but all that I can borrow.	Woodrow Wilson	
The system is the solution.	AT&T	
The power of hiding ourselves from one another is mercifully given, for men are wild beasts, and would devour one another but for this protection.	Henry Ward Beecher	
Nobody can give you freedom. Nobody can give you equality or justice or anything. If you're a man, you take it.	Malcom X	
I can't go on, I'll go on.	Samuel Beckett	
Nothing has more strength than dire necessity.	Euripides	
A schedule defends from chaos and whim.	Annie Dillard	
In lack of judgement great harm arises.	Aeschylus	
By all means marry. If you find a good wife, you'll be happy; if you find a bad one, you'll become a philosopher.	Socrates	
Money is of a prolific generating nature. Money can beget money and it's offspring can beget more.	Benjamin Franklin	
A common danger unites even the bitterest enemies.	Aristotle	
The one who has knowledge uses his words with restraint, and whoever has understanding is eventempered.	Proverbs 17	
Fools have no pleasure in understanding but delight in airing their own opinions.	Proverbs 18	
Learning to ignore things is one of the best paths to inner peace.	Robert J. Sawyer	
There are many things of which a wise man might choose to be ignorant.	Ralph Waldo Emerson	
Ambition is not a vice of little people.	Michel de Montaigne	
Routine, in an intelligent man, is a sign of ambition	W. H. Auden	
Man is not affected by events, but by the view he takes of them	Epictetus	
Love of bustle is not industry	Seneca	
It is not that we have a short space of time, but that we waste much of it.	Seneca	
Ever tried. Ever failed. No matter. Tri again. Fail again. Fail better.	Samuel Beckett	
The existential vacuum manifests itself mainly in a state of boredom.	Viktor Frankl	
Life is too short to be small.	Benjamin Disraeli	
Unless you pay the price for success you will not know it's worth	Apoorve Dubey	
Perfection is not when there is no more to add, but no more to take away.	Antoine de Saint-Exupéry	
It is vain to do with more what can be done with less.	William of Occam	
One does not accumulate. It is not daily increase but daily decrease. The height of cultivation always runs to simplicity.	Bruce Lee	
One who is good of his own free will shall not lack in happiness.	Aeschylus	
Leisure is the mother of philosophy.	Thomas Hobbes	
The rest I keep silent; a great ox stands on my tongue.	Aeschylus	
A kingdom founded on injustice will never last.	Seneca	
Death may be the greatest of all human blessings	Socrates	
In the country of the blind the one eyed man is king.	Desiderius Erasmus	
The best time to plant a tree was 20 years ago. The second best time is now.	Chinese proverb	
An investment in knowledge pays the best interest.	Benjamin Franklin	
The superior man acts before he speaks, and afterwards speaks according to his action.	Confucius	
You are guaranteed zero failures if you never try, but you're also guaranteed zero successes.	Sean McCabe	
No man is free who is not master of himself.	Epictetus	
The summit of happiness is reached when a person is ready to be what he is.	Desiderius Erasmus	
Those that know, do. Those that understand, teach.	Aristotle	
Fine words and an insinuating appearance are seldom associated with true virtue.	Confucius	
All models are wrong, some are useful.	George Box	
Much learning does not teach understanding.	Heraclitus	
Without music, life would be a mistake.	Friedrich Nietzsche	
He who has a why to live for can bear almost any how.	Friedrich Nietzsche	
First, solve the problem. Then, write the code.	John Johnson	
The best solution to a problem is not to have it	Michal Migurski	
What people think of you is none of your business.	Amy Hatvany	
Beauty awakens the soul to act.	Dante	
The time you enjoy wasting is not wasted time.	Bertrand Russell	
The visionary lies to himself, the liar only to others.	Friedrich Nietzsche	
The temptation of our age is to look good without being good.	Brennan Manning	
Few people can be happy unless they hate some other person, nation or creed.	Bertrand Russell	
I would not give a fig for the simplicity this side of complexity, but I would give my life for the simplicity on the other side of complexity.	Oliver Wendell Holmes	
All happy families are alike; each unhappy family is unhappy in its own way.	Leo Tolstoy	Ana Karenina
Programs must be written for people to read, and only incidentally for machines to execute.	Abelson, Sussman, et. al.	
If we offend, it is with our good will that you should think, we come not to offend, but with good will. To show our simple skill, that is the true beginning of our end.	William Shakespeare	A Midsummer Night’s Dream
It's just a job. Grass grows, birds fly, waves pound the sand. I beat people up.	Muhammad Ali	
Virtue is more to be feared than vice, because its excesses are not subject to the regulation of conscience.	Adam Smith	
On the road from the city of skepticism I had to pass through the valley of ambiguity.	Adam Smith	
When it becomes serious, you have to lie.	Jean-Claude Juncker	
Before the Roman came to Rye or out to Severn strode, the rolling English drunkard made the rolling English road.	GK Chesterton	
It is fitting that a liar should be a man of good memory.	Maurcus Fabius Quintilian	
Do. Or do not. There is no try.	Master Yoda	Star Wars
Never attribute to malice that which is adequately explained by stupidity,	Hanlon's razor	
This is a good death. There’s no shame in this. In a man’s death, a man who has done fine works.	The Operative	Serenity
So convenient a thing is it to be a reasonable creature, since it enables one to find or make a reason for everything one had in mind to do.	Benjamin Franklin	
Unfortunately, in human relations, people seek to assign blame and avoid responsibility. But in reality, there is no blame, only responsibility.	Master Bho Li	The Tale of Zen
Software is eating the world.	Marc Andreesen	
We know what we are, but know not what we may be.	William Shakespeare	
You are terminated.	The Terminator	
You're fired!	The Apprentice	
Resistance is futile.	The Borg	Star Trek
Qapla'!	Klingon phrase	
Live long and prosper.	Vulcan phrase	
Go forth and multiply.	Genesis 1:21,28; 9:1 (paraphrased)	The Bible
Rosebud.	Citizen Kane	
Today is a good day to die.	Klingon phrase	
Logic will get you from A to B. Imagination will take you everywhere.	Albert Einstein	
Everybody's got a plan. Then they get hit.	Mike Tyson	
Though this be madness, yet there is method in't.	William Shakespeare	The tragedy of Hamlet, Prince of Denmark
That will prove awful both in deed and word.	William Shakespeare	Pericles, Prince of Tyre
And, I pray thee now, tell me for which of my bad parts didst thou first fall in love with me?	William Shakespeare	Much ado about nothing
You must learn a new way to think before you can master a new way to be.	Marianne Williamson	
No one gossips about other people's secret virtues.	Bertrand Russell	
The good or ill of man lies within his own will.	Epictetus	
I do not enlighten those who are not eager to learn, nor arouse those who are not anxious to give an explanation themselves. If I have presented one corner of the square and they cannot come back to me with the other three, I should not go over the points again	Confucius	
There is no such uncertainty as a sure thing.	Robert Burns	Collected Poems of Robert Burns
But to see her was to love her, love but her, and love forever.	Robert Burns	
I am little acquainted with politeness, but I know a good deal of benevolence of temper and goodness of heart.	Robert Burns	The Letters Of Robert Burns
To be free of conflict you need to have no friends.	Nassim Ben Taleb	
Do not go gentle into that good night.	Dylan Thomas	
Do all the good you can, by all the means you can, in all the ways you can, in all the places you can, at all the times you can, to all the people you can, as long as ever you can.	John Wesley	
The more they overthink the plumbing, the easier it is to stop up the drain.	Scotty	Star Trek
Your representative owes you, not his industry only, but his judgment; and he betrays, instead of serving you, if he sacrifices it to your opinion.	Edmund Burke	
Any man can make mistakes, but only an idiot persists in his error.	Cicero	
He who does not understand your silence will probably not understand your words.	Elbert Hubbard	
The fault, dear Brutus, is not in our stars, But in ourselves, that we are underlings.	Cassius	Julius Caesar (William Shakespeare)
Any application that can be written in JavaScript, will eventually be written in JavaScript.	Atwood's Law	
I think the surest sign that intelligent life exists elsewhere in the universe is that none of it has tried to contact us.	Bill Watterson	
So make your exit with grace - the same grace shown to you.	Marcus Aurelius	`
And when it rains on your parade, look up rather than down. Without the rain, there would be no rainbow.	Gilbert K. Chesterton	
All that really belongs to us is time; even he who has nothing else has that.	Baltashar Gracian	
Sleep that knits up the raveled sleeve of care, The death of each day’s life, sore labour’s bath, Balm of hurt minds, great nature’s second course, Chief nourisher in life’s feast.	William Shakespeare	Macbeth
Nothing great was ever done without much enduring.	St. Catherine of Siena	
The quieter you become the more you can hear.	Ram Das	
Every storm is a school. Every trial is a test. Every experience is an education. Every difficulty is for your development.	Lance Watson	
When you have accomplished your daily task, go to sleep in peace; God is awake.	Victor Hugo	
If you want to kill any idea in the world, get a committee working on it	Charles Kettering	
Effort is only effort when it begins to hurt	Jose Ortega Gasset	
They travel lightly whom God's grace carries	Thomas a Kempis	
Now is the time for all good men to come to the aid of the party	Charles E. Welter	
In a gentle way can shake the world	Mahatma Gandhi	
Question everything. Learn something. Answer nothing.	Euripides	
Those of you who are inclined to worry have the widest selection in history	Mark Twain	
Be a pragmatist - not a fundamentalist. Never commit to an idea, only to progress and results.	Martin Berkhan	
Buy when the there's blood on the streets, even if the blood is your own	Baron Rothschild	
I quote others only in order the better to express myself	Michel de Montaigne	
Conquering others takes force. Conquering yourself is true strength.	Lao-tzu	
The saddest words of mice and men are these: it might have been.	A poet	
Hope is a waking dream	Aristotle	
He who learns must suffer. And even in our sleep, pain that cannot forget falls drop by drop upon the heart. And in our own despair, against our will, comes wisdom to su by the awful grace of God.	Aeschylus	
Everyone thinks of changing the world, but no one thinks of changing himself.	Leo Tolstoy	
The things that matter the most must never be at the mercy of the things that matter the least.	Goethe	
It is a psychological law that whatever we wish to accomplish we must impress on the subjective or subconscious mind.	Orison Swett Marden	
Whatever you can hold in your mind on a continuing basis, you can have.	John Boyle	
Live to the point of tears.	Albert Camus	
Make the best use of what is in your power, and take the rest as it happens.	Epictetus	
The secret of getting ahead is getting started.	Mark Twain	
I have discovered that all human evil comes from this, man's being unable to sit still in a room.	Blaise Pascal	
Silence is more eloquent than words.	Thomas Carlyle	
Get at least eight hours of beauty sleep. Nine if you're ugly.	Betty White	
Better a diamond with a flaw than a pebble without.	Confucius	
You always admire what you really don't understand.	Blaise Pascal	
Money is like manure. It is not good unless it's spread.	Francis Bacon	
Envy is the ulcer of the soul.	Socrates	
Dreams don't work unless you do.	Unknown	
Death is nothing to us, since when we are, death has not come, and when death has come, we are not.	Epicurus	
We only know of one duty, and that is to love.	Albert Camus	
Poverty of goods is easily cured; poverty of soul, impossible.	Michel de Montaigne	
We are always in our own company.	Friedrich Nietzsche	
Imagination decides everything.	Blaise Pascal	
So very difficult a matter is it to trace and find out the truth of anything by history.	Plutarch	
The essence of knowledge is, having it, to apply it; not having it, to confess your ignorance.	Confucius	
No man is exempt from saying silly things; the mischief is to say them deliberately.	Michel de Montaigne	
The man who insists on seeing with perfect clearness before he decides, never decides.	Henri Frederic Amiel	
By hating that person, you have lost something very sweet in yourself.	Sri Chinmoy	
Real knowledge is to know the extent of one's ignorance.	Confucius	
By definition, a government has no conscience. Sometimes it has policy, but nothing more.	Albert Camus	
The ideal man bears the accidents of life with dignity and grace, making the best of circumstance.	Aristotle	
The real world is much smaller than the imaginary.	Friedrich Nietzsche	
A confession has to be part of your new life.	Ludwig Wittgenstein	
Everyone would like to behave like a pagan, with everyone else behaving like a Christian.	Albert Camus	
Immaturity is the incapacity to use one's intelligence without the guidance of another.	Immanuel Kant	
The end of life is to be like God, and the soul following God will be like Him.	Socrates	
What a peculiar privilege has this little agitation of the brain which we call 'thought'.	David Hume	
The expert in anything was once a beginner.	Germany Kent	
One should die proudly when it is no longer possible to live proudly.	Friedrich Nietzsche	
It is natural to give a clear view of the world after accepting the idea that it must be clear.	Albert Camus	
Sincerity is the way of Heaven.	Mencius	
If a man is proud of his wealth, he should not be praised until it is known how he employs it.	Socrates	
Hope is only the love of life.	Henri Frederic Amiel	
Pleasure in the job puts perfection in the work.	Aristotle	
He who is not contented with what he has, would not be contented with what he would like to have.	Socrates	
Happiness is not a destination; it is a way of life.	Unknown	
A prudent question is one half of wisdom.	Sir Francis Bacon	
Truth is not only violated by falsehood; it may be equally outraged by silence.	Henri Frederic Amiel	
There is only one good, knowledge, and one evil, ignorance.	Socrates	
Not to be absolutely certain is, I think, one of the essential things in rationality.	Bertrand Russell	
Few things are impossible to diligence and skill; great works are performed not by strength, but by perseverance.	Samuel Johnson	
Genius is the ability to put into effect what is in your mind. There is no other definition for it.	F. Scott Fitzgerald	
We cannot spend our day in explanation.	Emerson	
Man can alter his life by altering his thinking.	William James	
In his errors a man is true to type. Observe the errors and you will know the man.	Confucius	
Thinking is like loving or dying. Each of us must do it for ourselves.	Josiah Royce	
Our greatest glory is not in never falling, but in rising every time we fall.	Confucius	
There is no failure except in no longer trying. There is no defeat except from within, no really insurmountable barrier save		
our own inherent weakness of purpose.	Elbert Hubbard	
Adversity has the effect of drawing out strength and qualities of a man that would have lain dormant in its absence.	Herodotus	
Happiness is a state of activity.	Aristotle	
Death is a friend of ours; and he that is not ready to entertain him is not at home.	Sir Francis Bacon	
To be prepared against surprise is to be trained. To be prepared for surprise is to be educated.	James Carse	Finite and Infinite Games
Imagination was given to man to compensate for what he is not. A sense of humour to console him for what he is.	Unknown	
If you want to improve, be content to be thought foolish and stupid.	Epictetus	
First say to yourself what you would be; and then do what you have to do.	Epictetus	
Many people would rather die than think; in fact, most do.	Bertrand Russell	
War is delightful to those who have no experience of it.	Desiderius Erasmus	
Any man who tries to be good all the time is bound to come to ruin among the great number who are not good.	Niccolo Machiavelli	
Hope is a good breakfast but a bad supper.	Sir Francis Bacon	
I care not so much what I am to others as what I am to myself.	Michel de Montaigne	
Better a diamond with a flaw than a pebble without.	Confucius	
Forget injuries; never forget kindness.	Confucius	
It is the nature of desire not to be satisfied, and most men live only for the gratification of it.	Aristotle	
To be without some of the things you want is an indispensable part of happiness.	Bertrand Russell	
Happiness depends upon ourselves.	Aristotle	
The superior man is satisfied and composed; the mean man is always full of distress.	Confucius	
The real problem of humanity ... we have Palaeolithic emotions; medieval institutions; and godlike technology.	E. O. Wilson	
Nothing exists except atoms and empty space; everything else is opinion.	Democritus	
Knowledge, if it does not determine action, is dead to us.	Plotinus	
Life can only be understood backwards, but it must be lived forwards.	Albert Camus	
Love is a state in which a man sees things most decidedly as they are not.	Friedrich Nietzsche	
And in knowing that you know nothing, that makes you the smartest of all.	Socrates	
Let the first impulse pass. Wait for the second.	Baltasar Gracian	
All wealth is the product of labor	John Locke	
The people may be made to follow a path of action, but they may not be made to understand it.	Confucius	
I've formed the habit of liking you.	F. Scott Fitzgerald	Head and Shoulders
Age carries away all things, even the mind.	Virgil	
The struggle ends when the gratitude begins.	Neale Donald Walsch	
Emptiness is the fasting of the mind.	Zhuangzi	
If we are to understand how the world really works, we need to understand the big ideas and how they work.	Charlie Munger	
When you think everything is someone else's fault you will suffer a lot.	Dalai Lama	
You may have to fight a battle more than once to win it.	Margaret Thatcher	
By three methods we may learn wisdom: First, by reflection, which is nobles; Second, by imitation, which is easiest; and third by experience, which is the bitterest.	Confucius	
One person with a belief is equal to a force of 99 who only have interests.	John Stuart Mill	
People demand freedom of speech as a compensation for freedom of thought, which they seldom use.	Soren Kiekegaard	
Freedom of speech is useless without freedom of thought.	Spiro	
Men who are unhappy, like men who sleep badly, are always proud of the fact.	Bertrand Russell	
In charity there is no excess.	Sir Francis Bacon	
Without courage, wisdom bears no fruit	Baltasar Gracian	
The desire to write grows with writing.	Desiderius Erasmus	
They must often change who would be constant in happiness or wisdom.	Confucius	
Love knows not its own depth until the hour of separation.	Kahlil Gibran	
Experience is what you get when you didn't get what you wanted.	Howard Marks	
If you've been playing poker for half an hour and you still don't know who the patsy is, you're the patsy.	Warren Buffett	
Wordly wisdom teaches that it is better for reputation to fail conventionally than to succeed unconventionally.	John Maynard Keynes	
The map is not the territory.	Korzybski	
To Thales the primary question was not what do we know, but how do we know it.	Aristotle	
Autumn is a second spring when every leaf is a flower.	Albert Camus	
Time discovers truth.	Seneca	
Not everything that counts can be counted, and not everything that can be counted counts.	Albert Einstein	
Your pain is the breaking of the shell that encloses your understanding.	Kahil Gibran	
The power of instruction is seldom of much efficacy, except in those happy dispositions where it is almost superfluous.	Edward Gibbon	
God is not willing to do everything, and take away that share of glory that belongs to us.	Machiavelli	
Don't fear moving slowly. Fear standing still.	Chines proverb	
Focus is about saying no.	Steve Jobs	
No man who ever held the office of President would congratulate a friend on obtaining it.	John Adams	
Most interesting phenomena have multiple causes.	N. P. Calderwood	
The best writing is rewriting.	E.B. White	
The greatest dangers to liberty lurk in insidious encroachment by men of zeal, well-meaning but without understanding.	Brandeis	
Don't worry about what anybody else is going to do. The best way to predict the future is to invent it.	Alan Kay	
Short words are best and the old words when short are best of all.	Sir Winston Churchill	
Change breaks the brittle.	Jan Houtema	
The less confident you  are, the more serious you have to act.	Tara Ploughman	
All good things are wild and free.	Henry David Thureau	
How many people work in the Vatican? About half.	Vatican anectode	
Man is most nearly himself when he achieves the seriousness of a child at play.	Heraclitus	
I was seldom able to see an opportunity until it had ceased to be one.	Mark Twain	
If your ship doesn't come swim out to meet it.	Jonathan Winters	
When faced with competing alternative courses of action or competing conclusions, choose the one that rests upon the fewest assumptions.	Occam's razor	
Most men die at 27. We just bury them at 72.	Mark Twain	
One repays a teacher badly if one always remains nothing but a pupil.	Friedrich Nietzsche	
The past is certain, the future obscure.	Thales	
What is a friend? A single soul dwelling in two bodies.	Aristotle	
I can show you where to dig, and what to dig for, but the digging you must do for yourself.	Matisyahu	
All paid jobs absorb and degrade the mind.	Aristotle	
The most painful state of being is remembering the future, particularly the one you'll never have.	Soren Kiekegaard	
There is nothing permanent except change.	Heraclitus of Ephesus	
It is the chiefest point of happiness that a man is willing to be what he is.	Desiderius Erasmus	
Much learning does not teach understanding.	Heraclitus	
The self is not something ready-made, but something in continuous formation through choice of action.	John Dewey	
If you care about what other people think, you will always be their prisoner.	James Frey	
The two greatest warriors are patience and time.	Leo Tolstoy	
Be careful when you fight the monsters, lest you become one.	Friedrich Nietzsche	
Nothing is more honourable than a grateful heart.	Seneca	
A wise man gets more use from his enemies than a fool from his friends.	Baltasar Gracian	
To understand is to be free.	Spinoza	
From a seed a mighty trunk may grow.	Aeschylus	
No one heals himself by wounding another.	Ambrose	
The actions of men are the best interpreters of their thoughts.	John Locke	
In order to succeed your desire for success should be greater than your fear of failure.	Anonymous	
Each heart knows its own bitterness, and no one else can share its joy.	The Book of Proverbs	
The mind unlearns with difficulty what it has long learned.	Seneca	
Life is short, art long, opportunity is fleeting, experience is treacherous, and judgment is difficult.	Hypocrites	
Hofstadter's Law: It always takes longer than you expect, even when you take into account Hofstadter's Law.	Douglas Hofstadter	
We are what we repeatedly do. Excellence, then, is not an act, but a habit.	Aristotle	
We live but for a moment.	Marcus Aurelius	
It is possible to commit no mistakes and still lose. That is not a weakness; that is life.	Jean-Luc Picard	
Only the educated are free.	Epictetus	
If a man takes no thought what is distant, he will find sorrow near at hand.	Confucius	
It doesn't matter how slowly you go as long as you don't stop.	Confucius	
If you put fences around people, you get sheep.	William L. McKnight	
We make war that we may live in peace.	Aristotle	
Mothers are fonder than fathers of their children because they are more certain they are their own.	Aristotle	
Honour is the reward of virtue	Cicero	
If you do the work, you will be rewarded. There are no shortcuts in life.	Michael Jordan	
Problems worth solving will present themselves. There's no need to invent busywork.	Picard management tips	
We shall never have more time. We have, and have always had, all the time there is.	Arnold Bennett	How to live on 24 hours a day
The man who dares to waste an hour of time has not discovered the value of his life.	Charles Darwin	
The impediment to action advances action. What stands in the way becomes the way.	Marcus Aurelius	
There is no more miserable human being than the one for whom the beginning of every bit of work must be decided anew each day.	William James	
Know that no one is free, except Zeus.	Aeschylus	
Hard work isn't enough, and more work is never the real answer.	Reid Hoff	
Fall seven, rise eight.	Japanese saying	
Self-control in a man who does not act wisely is the weakest of all things.	Aeschylus	
Growth begins when we begin to accept our own weakness.	Jean Vanier	
Last words are for people who haven't said anyting in life.	Karl Marx	
Poverty of goods is easily cured; poverty of soul, impossible.	Michel de Montaigne	
We do not judge the people we love.	Jean-Paul Sartre	
A youth is to be regarded with respect. How do we know that his future will not be equal to our present?	Confucius	
To be a hero or a heroine, one must give an order to oneself.	Simone Weil	
Not life, but good life, is to be chiefly valued.	Socrates	
Never listen to people who speak badly of others and good of you.	Tolstoy	
Much that passes as idealism is disguised hatred or disguised love of power.	Bertrand Russell	
Children have never been very good at listening to their elders, but they have never failed to imitate them.	James Baldin	
Ignorance is the night of the mind, but a night without moon and star.	Confucius	
Truth uttered before its time is always dangerous.	Mencius	
What you are must always displease you, if you would attain to that which you are not.	Augustine	
It is not titles that honour men, but men that honour titles.	Machiavelli	
A man who tosses worms in the river isn't necessarily a friend of the fish.	Malcom X	
There is no conversation more boring than the one where everybody agrees.	Michel de Montaigne	
If you find a path with no obstacles it probably doesn't lead anywhere.	Frank Clark	
There is no such thing as the view from nowhere or from everywhere, for that matter. Our point of view biases our observation, consciously or unconsciously. You cannot understand the view without the point of view.	Noam Shpancer	
A rabbit runs faster than a fox because it is running for his life while the fox is only running for his dinner. Richard Dawkins		
He who begins being a friend for the sake of expediency will also stop for the sake of expediency.	Seneca	
A wise man gets more use from his enemies than a fool from his friends.	Baltasar Gracian	
War does not determine who is right, only who is left.	Bertrand Russell	
He who speaks without modesty will find it difficult to make his words good.	Confucius	
Inspiration is for amateurs.	Chuck Close	
If your plan is for one year plant rice. If your plan is for ten years plant trees. If your plan is for one hundred years educate children.	Confucius	
Love is the attempt to form a friendship inspired by beauty.	Cicero	
All the tyrants of Sicily never invented a worse torment than envy.	Horace	
All exact science is dominated by the idea of approximation.	Bertrand Russell	
An error is the more dangerous the more truth it contains.	Henri Frederic Amiel	
Government can exist without laws, but law cannot exist without government.	Bertrand Russell	
I've never known any trouble that an hour's read didn't assuage.	Charles de Secondat	
Instead of imagining that our main task is to instruct a computer what to do, let us concentrate rather on explaining to human beings what we want a computer to do.	Donald Knuth	
Dost thou love life? Then do not squander time; for that's the stuff life is made of.	Benjamin Franklin	
You are the easiest person to fool.	Richard Feynman	
A little learning is a dangerous thing; drink deep, or taste not the Pierian spring: There shallow draughts intoxicate the brain, and drinking largely sobers us again.	Alexander Pope	
If you only read the books that everyone else is reading, you can only think what everyone else is thinking.  Haruki Murakami		
A wealth of information creates a poverty of attention.	Herbert Simon	
What is life, if full of care, we have not time to stop and stare.	W.H. Davies	
Life is difficult.	M. Scott Peck	The road less travelled
When brothers agree, no fortress is so strong as their common life.	Antisthenes	
Even the king in his riches does not escape death.	Aeschylus	
The most profound joy has more of gravity than of gaiety in it.	Michel de Montaigne	
Blushing is the colour of virtue.	Diogenes Laertius	
Cleverness is not wisdom.	Euripides	
Kindly words do not enter so deeply into a men as a reputation for kindness.	Mencius	
From a small seed a mighty trunk may grow.	Aeschylus	
We know truth, not only reason, but also by the heart.	Blaise Pascal	
Perserver and perserver yourselves for better circumstances.	Virgil	
An object in possession seldom retains the same charm it had in pursuit.	Pliny the Younger	
Having the fewest wants, I am nearest to the gods.	Socrates	
Words are doctors to a diseased temperament.	Aeschylus	
Managers who don't know to measure what they want settle for wanting what they can measure.	Russell Ackoff	
Everything new comes from some other beginning's end.	Seneca	
Poverty is the parent of revolution and crime.	Aristotle	
Know not to revere human things too much.	Aeschylus	
The firm, the enduring, the simple and the modest are near to virtue.	Confucius	
A man of understanding has lost nothing, if he has himself.	Michel de Montaigne	
The fox has many tricks. The hedgehog has but one. But that is the best of all.	Desiderius Erasmus	
You cannot truly listen to anyone and do anything else at the same time.	M. Scott Peck	
There is no greater concurrence between learning and wisdom.	Sir Francis Bacon	
Pleasure is the beginning and the end of living happily.	Epicurus	
Do not ask for what you will wish you had not got.	Seneca	
The higher you climb on the mountain, the harder the wind blows.	Sam Cummings	
Freedom of opinion can only exist when the government thinks itself secure.	Bertrand Russell	
Men never do evil so completely and cheerfully as when they do it from a religious conviction.	Blaise Pascal	
If the only prayer you ever say in your whole life is 'thank you', that would suffice.	Meister Eckhart	
The smile is the beginning of love.	Mother Teresa	
Learn to be happy with what you have while you pursue all that you want.	Jim Rohn	
It is hard to fight against emotion, but harder still to fight against pleasure.	Heraclitus	
I have taken all knowledge to be my province.	Sir Francis Bacon	
Again, men in general desire the good, and not merely what their fathers had.	Aristotle	
These are not the problems associated with the ministry, they are the ministry.	Bishop of Kensington	
To find yourself, think for yourself.	Socrates	
The measure of who we are is how we react to something that doesn't go our way.	Gregg Popovich	
I care not so much what I am to others as what I am to myself.	Michel de Montaigne	
The most necessary learning is that which unlearns evil.	Antisthenes	
Come what may, all bad fortune is to be conquered by endurance.	Virgil	
In health there is freedom. Health is the first of all liberties.	Henric Frederic Amiel	
To forget one's purpose is the commonest form of stupidity.	Friedrich Nietzsche	
Evil when we are in its power is not felt as evil but as a necessity, or even a duty.	Simone Weil	
But what is happiness except the simple harmony between a man and life he leads?	Albert Camus	
Even in civilized mankind faint traces of monogamous instincts can be perceived.	Bertrand Russell	
Reading maketh a full man, conference a ready man, and writing an exact man.	Sir Francis Bacon	
Life is neither good or evil, but only a place for good or evil.	Marcus Aurelius	
He who controls others may be powerful, but he who has mastered himself is mightier still.	Lao-tzu	
Before you embark on a journey of revenge, dig two graves.	Confucius	
Men despise religion. They hate it and are afraid it may be true.	Blaise Pascal	
First learn the meaning of what you say and then speak.	Epictetus	
Socialism is nothing but the capitalism for the lower classes.	Oswald Spengler	
Thou shouldest eat to live, not live to eat.	Socrates	
Thrift is of great revenue.	Cicero	
How will you ever be polished if you are irritated by every rub?	Rumi	
Be kind, for everyone you meet is fighting a harder battle.	Plato	
Trust one who has tried.	Virgil	
Man is not a rational animal he is a rationalizing animal.	Robert A. Heinlein	
We are twice armed if we fight with faith.	Plato	
Who is blind, dumb and deaf will live a peaceful life of a hundred years.	Siddha Nagarjuna	
Originality is the one thing which unoriginal minds cannot feel the use of.	John Stuart Mill	
As soon as there is life there is danger.	Ralph Waldo Emerson	
Bad mind, bad heart.	Anacharsis	
Strangers are simply friends who have not yet met.	William Butler Yeats	
Speak your truth quietly and clearly.	Desiderata	
Complexity is failed simplicity.	Edward de Bono	
An expert is a person who has made all the mistakes that can be made in a very narrow field.	Niels Bhor	
Anyone who lives within their means suffers from a lack of imagination.	Oscar Wilde	
Whenever you find yourself on the side of the majority it is time to reflect.	Mark Twain	
Ordinarily he was insane, but he had lucid moments when he was merely stupid.	Heinrich Heine	
Reality is an illusion, albeit a very persistent one.	Albert Einstein	
Be silent, or say something better than silence	Pythagoras	
The reasonable man adapts himself to the world; the unreasonable one persists in trying to adapt the world to himself. Therefore all progress depends on the unreasonable man.	George Bernard Shaw	
It is not a lack of love, but a lack of friendship that makes unhappy marriages.	Friedrich Nietzsche	
Action may not bring happiness, but there can be no happiness without action.	Benjamin Disraeli	
Keep your eyes open before marriage, and half shut afterwards.	Benjamin Disraeli	
The first principle is that you must not fool yourself, and you are the easiest person to fool.	Richard Feynman	
The stupidity of people comes from having an answer for everything. The wisdom of the novel comes from having a question for everything.	Milan Kundera	
Pleasure in the job puts perfection in the work.	Aristotle	
Those who talk should do and only those who do should talk.	Sextus Empiricus	Against the Professors
The future ain't what it used to be.	Yogi Berra	